070009100
500006390
103000000
069000830
000000000
000308402
205000000
008074021
607800009