000070950
200000000
000940007
070000006
130097208
006800000
001000070
003009864
009560001