070000000
050093740
302780009
500000082
093000000
016400900
000030205
700001030
000002071