000000350
002000000
030005780
600000903
084200100
000040070
400008009
700010000
050000030