000608000
020003010
000050000
000032000
083005200
400070086
806000002
000046000
107000005