008007000
040000290
300000000
000060507
760900040
500001080
000020410
000000030
000548000