000900000
407630000
031000002
000713000
200005000
300000970
850009700
046820000
000100400