003006080
607003000
000000010
000000400
010200000
376040002
005027090
800900003
090600245