100040008
005000000
000010000
000002500
700100406
850900001
010000079
900700860
670030200